1111111111
1000E000C0
1111110001
11P0C0C001
1111111111