111111111111111
1C1110000111111
101110110111111
100000110001111
101110110001111
1111101100P1111
1C0000011111111
111111000000011
111111011000011
11E000011000C11
111111111111111
